14 14 14 14 14 14 14 14 14 14 14 14 14 14 14 14 14 54 55 56 14 14 14 14 14 14 14 14 14 14 14 14 14 14 14 14 14 14 14 14 14 14 14 14 54 55 55 55 55 55
14 14 14 14 14 14 14 14 14 14 14 14 14 14 14 14 14 54 55 56 14 14 14 14 14 14 14 14 14 14 14 14 14 14 14 14 14 14 14 14 14 14 14 54 55 55 55 55 55 55
14 14 14 14 14 14 14 14 14 14 14 14 14 14 14 14 14 54 55 56 14 14 14 14 14 14 14 14 14 14 14 14 14 14 14 14 14 14 14 14 14 14 14 14 54 55 55 55 55 55
14 14 14 14 14 14 14 14 14 14 14 14 14 14 14 14 14 54 55 56 14 14 14 14 14 14 14 14 14 14 14 14 14 14 14 14 14 14 14 14 14 14 14 14 54 55 55 55 55 55
14 14 14 14 14 14 14 14 14 14 14 14 14 14 14 14 14 54 55 56 14 14 14 14 14 14 14 14 14 14 14 14 14 14 14 14 14 14 14 39 40 41 42 43 54 55 55 55 55 55
14 14 14 14 14 14 14 14 14 14 14 14 14 14 14 14 14 54 55 56 14 14 14 14 14 14 14 14 14 14 14 14 14 14 14 14 14 14 14 44 45 46 47 48 54 55 55 55 55 55
14 14 14 14 14 14 14 14 14 14 14 14 14 14 14 14 14 54 55 56 14 14 26 27 28 29 30 14 14 14 14 14 14 14 14 14 14 14 14 49 50 51 52 53 54 55 55 55 55 55
14 14 14 14 14 14 14 14 14 14 10 14 14 14 14 14 14 54 55 56 14 14 36 15 15 32 14 14 14 14 14 14 14 14 14 14 14 14 10 10 10 10 14 14 54 55 55 55 55 55
14 14 14 14 14 14 14 14 14 14 10 14 14 14 14 14 14 54 55 56 14 14 36 15 15 32 14 14 14 14 14 14 14 14 14 14 14 14 14 14 10 10 14 14 54 55 55 55 55 55
14 14 14 14 14 14 14 14 14 14 10 14 14 14 14 14 14 54 55 56 14 14 36 15 15 32 14 14 14 14 14 14 14 14 14 14 14 14 14 14 10 10 14 14 54 55 55 55 55 55
14 14 14 14 14 14 14 14 14 14 10 14 14 14 14 14 14 54 55 56 14 14 36 15 15 32 14 14 14 14 14 14 14 14 14 14 14 14 14 14 10 10 14 14 54 55 55 55 55 55
14 14 14 14 14 14 14 14 10 10 10 14 14 14 14 14 14 54 55 56 14 14 36 15 15 32 14 14 14 14 14 14 14 14 14 14 14 14 14 14 10 10 14 14 54 55 55 55 55 55
14 14 14 14 14 14 14 14 10 14 14 14 14 14 14 14 14 54 55 56 14 14 36 15 15 32 14 14 14 14 14 14 14 14 14 14 14 14 14 14 10 10 14 14 54 55 55 55 55 55
14 14 14 14 14 14 14 14 10 14 14 14 14 14 14 14 14 54 55 56 14 14 36 15 15 32 14 14 14 14 14 14 14 14 14 14 14 14 14 14 10 10 14 14 54 55 55 55 55 55
14 14 14 14 14 14 14 14 10 14 14 14 14 14 14 14 14 54 55 56 14 14 36 15 15 32 14 14 14 14 14 14 14 14 14 14 14 14 14 14 10 10 14 14 54 55 55 55 55 55
14 14 14 14 14 14 14 14 10 14 14 14 14 14 14 14 14 54 55 56 14 14 36 15 15 32 14 14 14 14 14 14 14 14 14 14 14 14 14 14 10 10 14 14 54 55 55 55 55 55
14 14 14 14 14 14 14 14 10 14 14 14 14 14 14 14 14 54 55 56 14 14 36 15 15 32 14 14 14 14 14 14 14 14 14 14 14 14 14 14 10 10 14 14 54 55 55 55 55 55
14 14 14 14 14 14 14 14 10 14 14 14 14 14 14 14 14 54 55 56 14 14 36 15 15 32 14 39 40 41 42 43 14 14 14 14 14 14 14 14 10 10 14 14 54 55 55 55 55 55
14 14 14 14 14 14 14 14 10 14 14 14 14 14 14 14 14 54 55 56 14 14 36 15 15 32 14 44 45 46 47 48 14 14 14 14 14 14 14 14 10 10 14 14 54 55 55 55 55 55
14 14 14 14 14 14 14 14 10 14 10 10 10 14 14 14 14 54 55 56 14 14 36 15 15 32 14 49 50 51 52 53 14 14 14 14 14 14 14 14 10 10 14 14 54 55 55 55 55 55
14 14 14 14 14 14 14 14 10 14 10 14 10 14 14 14 14 54 55 56 14 14 36 15 15 32 14 14 14 14 14 14 14 14 14 14 14 14 14 14 10 10 14 14 54 55 55 55 55 55
14 14 14 14 14 14 14 14 10 14 10 14 10 14 14 14 14 54 55 56 14 10 36 15 15 32 17 18 21 23 24 17 18 21 23 24 14 14 14 14 10 10 14 14 54 55 55 55 55 55
14 14 14 14 14 14 14 14 10 14 10 14 10 14 14 14 14 54 55 56 14 10 36 15 15 32 16 19 20 22 25 16 19 20 22 25 14 14 14 14 10 10 14 14 54 55 55 55 55 55
14 14 14 14 14 14 14 14 10 14 10 14 10 14 14 14 14 54 55 56 14 38 37 15 15 31 38 38 38 38 38 38 38 38 38 38 38 14 14 14 10 10 14 14 54 55 55 55 55 55
14 14 14 14 14 14 14 14 10 14 10 14 10 10 10 10 10 57 58 59 36 15 15 15 15 15 15 15 15 15 15 15 15 15 15 15 15 32 10 10 10 10 14 14 54 55 55 55 55 55
14 14 14 14 14 14 14 14 10 14 10 14 10 10 10 10 10 54 55 56 36 15 15 15 15 15 15 15 15 15 15 15 15 15 15 15 15 32 10 10 10 14 14 14 54 55 55 55 55 55
14 14 14 14 14 14 14 14 10 14 10 14 14 14 14 14 14 54 55 56 14 34 35 15 15 33 34 34 34 34 34 34 34 34 34 34 34 14 10 14 14 14 14 14 54 55 55 55 55 55
14 14 14 14 14 14 14 14 10 14 10 14 14 14 14 14 14 54 55 56 17 18 36 15 15 32 14 14 14 14 14 14 14 14 14 14 14 14 10 14 14 14 14 14 54 55 55 55 55 55
14 14 14 14 14 14 14 14 10 10 10 14 14 14 14 14 14 54 55 56 16 19 36 15 15 32 14 39 40 41 42 43 14 14 14 14 14 14 10 14 14 14 14 14 54 55 55 55 55 55
14 14 14 14 14 14 14 14 14 14 14 14 14 14 14 14 14 54 55 56 17 18 36 15 15 32 14 44 45 46 47 48 14 14 14 14 14 14 10 14 14 14 14 14 54 55 55 55 55 55
14 14 14 14 14 14 14 14 14 14 14 14 14 14 14 14 14 54 55 56 16 19 36 15 15 32 14 49 50 51 52 53 14 14 14 14 14 14 10 14 14 14 14 14 54 55 55 55 55 55
14 14 14 14 14 14 14 14 14 14 14 14 14 14 14 14 14 54 55 56 17 18 36 15 15 32 14 14 14 14 14 14 14 14 14 14 14 14 10 14 14 14 14 14 54 55 55 55 55 55
14 14 14 14 14 14 14 14 14 14 14 14 14 14 14 14 14 54 55 56 16 19 36 15 15 32 14 14 14 14 14 14 14 14 14 14 14 14 10 14 14 14 14 14 54 55 55 55 55 55
14 14 14 14 14 14 14 14 14 14 14 14 14 14 14 14 14 54 55 56 17 18 36 15 15 32 14 14 14 14 14 14 14 14 14 14 14 14 10 14 14 14 14 14 54 55 55 55 55 55
14 14 14 14 14 14 14 14 14 14 14 14 14 14 14 14 14 54 55 56 16 19 36 15 15 32 14 14 14 14 14 14 14 14 14 14 14 14 10 14 14 14 14 14 54 55 55 55 55 55
14 14 14 14 14 14 14 14 14 14 14 14 14 14 14 14 14 54 55 56 14 14 10 34 34 10 10 10 10 10 10 14 14 14 14 14 14 14 10 14 14 14 14 14 54 55 55 55 55 55
14 14 14 14 14 14 14 14 14 14 14 14 14 14 14 14 14 54 55 56 14 14 14 14 14 14 14 14 14 14 10 14 14 14 14 14 14 14 10 14 14 14 14 14 54 55 55 55 55 55
14 14 14 14 14 14 14 14 14 14 14 14 14 14 14 14 14 54 55 56 14 14 14 14 14 21 23 24 14 14 10 14 14 14 14 14 14 14 10 14 14 14 14 14 54 55 55 55 55 55
14 14 14 14 14 14 14 14 14 14 14 14 14 14 14 14 14 54 55 56 14 14 14 14 14 20 22 25 14 14 10 14 14 14 14 14 14 14 10 14 14 14 14 14 54 55 55 55 55 55
14 14 14 14 14 14 14 14 14 14 14 14 14 14 14 14 14 54 55 56 14 14 14 14 10 10 10 10 10 10 10 14 14 14 14 14 14 14 10 14 14 14 14 14 54 55 55 55 55 55
14 14 14 14 14 14 14 14 14 14 14 14 14 14 14 14 14 54 55 56 14 14 14 14 10 14 14 14 14 14 10 14 14 14 14 14 14 14 10 14 14 14 14 14 54 55 55 55 55 55
14 14 14 14 14 14 14 14 14 14 14 14 14 14 14 14 14 54 55 56 14 14 14 14 14 14 14 14 14 14 10 14 14 26 27 28 29 30 10 14 14 14 14 14 54 55 55 55 55 55
14 14 14 14 14 14 14 14 14 14 14 14 14 14 14 14 14 54 55 56 14 14 14 14 14 14 14 14 14 14 10 10 10 10 10 10 10 10 10 14 14 14 14 14 54 55 55 55 55 55
14 14 14 14 14 14 14 14 14 14 14 14 14 14 14 14 14 54 55 56 14 14 14 14 14 14 14 14 14 14 14 14 14 14 14 14 14 14 14 14 14 14 14 14 54 55 55 55 55 55
14 14 14 14 14 14 14 14 14 14 14 14 14 14 14 14 14 54 55 56 14 14 14 10 10 14 14 14 14 14 14 14 14 14 14 14 14 14 14 14 14 14 14 14 54 55 55 55 55 55
14 14 14 14 14 14 14 14 14 14 14 14 14 14 14 14 14 54 55 56 14 14 14 10 10 14 14 14 14 14 14 14 14 14 14 14 14 14 14 14 14 14 14 14 54 55 55 55 55 55
14 14 14 14 14 14 14 14 14 14 14 14 14 14 14 14 14 54 55 56 14 14 14 10 10 14 14 14 14 14 14 14 14 14 14 14 14 14 14 14 14 14 14 14 54 55 55 55 55 55
14 14 14 14 14 14 14 14 14 14 14 14 14 14 14 14 14 54 55 56 14 14 14 10 10 14 14 14 14 14 14 14 14 14 14 14 14 14 14 14 14 14 14 14 54 55 55 55 55 55
14 14 14 14 14 14 14 14 14 14 14 14 14 14 14 14 14 54 55 56 14 14 14 10 10 14 14 14 14 14 14 14 14 14 14 14 14 14 14 14 14 14 14 14 54 55 55 55 55 55
14 14 14 14 14 14 14 14 14 14 14 14 14 14 14 14 14 54 55 56 14 14 14 10 10 14 14 14 14 14 14 14 14 14 14 14 14 14 14 14 14 14 14 14 54 55 55 55 55 55
